Student Name	Classification								
"Galang, Japp Timothy G."	Undergraduate								
"Halbert, Dillon J."	Undergraduate								
"Hayes, Priscilla M."	Undergraduate								
"Rhodes, Suqoya J."	Undergraduate								
"Zhu, Pengxu"	Undergraduate								
"Aluru, Praneeth"	Graduate								
"Annavarapu, Aswini K."	Graduate								
"Atukuri, Sai Venkatesh"	Graduate								
"Avirneni, Anvesh"	Graduate								
"Bandi, Sai Vineeth Reddy"	Graduate								
"Boga, Rahul"	Graduate								
"Bolisetty, Nikhil"	Graduate								
"Bolloju, Satya Sai Srimannarayana Sarma"	Graduate								
"Cheedu, Venkat Narayan Reddy"	Graduate								
"Chittiprolu, Sai Manideep"	Graduate								
"Chundru, Tejasai"	Graduate								
"Gunti, Rahul Sathya"	Graduate								
"Jagamoni, Sravya"	Graduate								
"Kakkireni, Sai Nikhil"	Graduate								
"Kanduri, Karthik Reddy"	Graduate								
"Kantipudi, Bala Rama Krishna"	Graduate								
"Kondapalli, Venkata Phani Raj S."	Graduate								
"Kurri, Lakshmi Gayathri"	Graduate								
"Mandalapu, Sri Lakshmi Jahnavi"	Graduate								
"Manne, Kavya"	Graduate								
"Mundru, Jaya Krishna"	Graduate								
"Panchumarthi, Rajitha"	Graduate								
"Panchumarthi, Ramya"	Graduate								
"Panyala, Gunakar Reddy"	Graduate								
"Parne, Chakradhar Reddy"	Graduate								
"Pathi, Akhilesh"	Graduate								
"Sardar, Karan Singh"	Graduate								
"Sirigiri, Harinath"	Graduate								
"Suresh, Akash"	Graduate								
"Tella, Sowmya"	Graduate								
"Vadapally, Ramya Sree"	Graduate								
"Vanga, Mahesh Krishna Reddy"	Graduate								
"Vankayalapati, Vishnu Vardhan"	Graduate								
"Vemireddy, Soujanya"	Graduate								